XXXXXXXXXXXXXXXXXXXXXXXXXXXXXXXXXXXXXXXX
X.......................$..............X
X........................$.............X
X.........................$............X
X..........................$...........X
X...........................$..........X
X............................$.........X
X.............................$........X
X......................................X
XXXXXXXXXXXXXXXXXXXXXXXXXXXXXXXXXXXXXXXX
----------------------------------------